XMXXXXXXXXXXXXX
X  XX X       X
XX    X  XXXX X
XX XX    X    X
X  XXXX XX XXXX
X  XX X XX    X
X     X XXXXX X
XXXXXXX X     X
X       X XXXXX
X XXXXXXX     X
X XXXXXXXXXXX X
XXX           X
X   XXXXXXXXXXX
X             X
XXXXXXXXXXXXXGX